NO ./assets/NO.xpm
SO ./assets/SO.xpm
WE ./assets/WE.xpm
EA ./assets/EA.xpm

C 153,255,255

F 100,100,100

11111111111111111111
10000000000000000001
10000000000000000001
100000000S0000000001
10000000000000000001
10000000100000000001
10000000111000000001
10000000000000000001
10000000000000000001
11111111111111111111